XXXXXXXXXXXXXXXXXXXX
X__________________X
X__________________X
X__________________X
X______XXXXX_______X
X______XXXXX_______X
X______XXXXX_______X
X______XXXXX_______X
X______X___________X
XXXXXXXX___________X
X__________________X
X__________________X
X_____XXXXXXXXXXXXXX
X__________________X
X__________________X
X__________________X
XXXXXXXXXXXXX______X
X__________________X
X__________________X
XXXXXXXXXXXXXXXXXXXX