XXXXXXXXXXXXXXXXXXXX
XOOOOOOOOOOOOOOOOOOX
XOOOOOOOOOOOOOOOOOOX
XOOOOOOOOOOOOOOOOOOX
XOOOOOOOOOOOOOOOOOOX
XOOOOOOOOOOOOOOOOOOX
XOOOOOOOOOOOOOOOOOOX
XOOOOOOOOOOOOOOOOOOX
XOOOOOOOOOOOOOOOOOOX
XXXXXXXXOOOOXXXXXXXX
XOOOOOOOOOOOOOOOOOOX
XOOOOOOOOOOOOOOOOOOX
XOOOOOOOOOOOOOOOOOOX
XOOOOOOOOOOOOOOOOOOX
XOOOOOOOOOOOOOOOOOOX
XOOOOOOOOOOOOOOOOOOX
XOOOOOOOOOOOOOOOOOOX
XOOOOOOOOOOOOOOOOOOX
XOOOOOOOOOOOOOOOOOOX
XXXXXXXXXXXXXXXXXXXX